07.03.22
undermine - разрушать
faux pas
dip - sause
embassy - посольство


04.03.22
VOCABULARY
complain - жаловаться
attendants - обслуга
puttin your foot in it - вляпаться
due 


02.03.22
VOCABULARY
if the worst comes to the worst - в худшем случае
get a hold of yourself - брать себя в руки
calling - предназначение
redundant - 
blackmail - шантажировать
labour - рабочая сила


28.02.22
VOCABULARY
threat - угроза
awareness - осведомленность
distraction - отвлечение
plunged - резко упали
soared - резко увеличивать
wealthier - богатеи
take a plunge - выйти замуж
freak weather - необычная погода
evaporate - испарение
petri dish - стеклянная пробирка
mold - плесень
hand in my notice last week - предупредить об уходе
resing - уволиться
pay rise - повышение зарплаты
to make redundant - уволить
getting the hang - привыкать
to find my feat - привыкать
struggling to cope - застрял
reward - награда
drain - опустащать

GRAMMA
try to do --- try doing
I stoped smoking --- I stopped to smoke
I remember to doing --- I remembered to do
I regret to say --- I regret doing


18.02.22
VOCABULARE
money laundering - отмывание денег
behind bars - за решеткой
appeal - аппеляция
served - отбыл
offence - правонарушение
fine - штраф
convicted - осужден
to do time - сидит в тюрьме
jaywalking - переход улицы 
limp - хромать
cheated on - изменять
tear - порвать
ligaments - связки
according - по словам (according to the police)
doubt - сомнение
tremendous - огромный
hate crime - преступление на почве ненависти


14.02.22
VOCABULARE
blossom - цветение
flood - наводнение
seed - зерно
seed finance - начальное финансирование
stem - происхождение \ стебель
genuine - настоящий \ подлинный 
supply and demand - предложение и спрос
to catch redhanded / caught in the act - поймать с поличным
seized - конфисковать
came up to - подошел
grabbed - своровать
vanished / disappeared - исчез
ivory - слоновья кость
earthquack - землетресение
burgar - взломщик
lad - парень in British, lads ребята
relief - облегчение
spoil - испорченная
decent - достойный
dump - помойка
overlooking - смотрящий, выходящий, с видом
overlook - пропустить, упустить из виду
posh - шикарный
unbearably - нестерпимо
youths - молодешь
suspiciously - подозрительно
chase - преследовать
keep up - успевать
ignorance - невежество
bliss - блаженство
to brew - варить (кофе)
to boil - варить (картошка)
lame excuse - отмазка, неубедительное оправдание
agile - ловкий, гибкий
furious - яростный
sissy boy - маменькин сынок

HOMEWORK
IDIOMS
1. Bated breath
I was waited with bated breath for the results of my exam.
2. Can't stand the pace
Plaing the drums, I can not stand the pace.
3. Ignorance is bliss.
4. Bear fruit.
5. Jog someone's memory
Before the exam, I had joged my friend's memory.
6. Easy as pie.
Once you try it, you will understand that it is easy as pie.
7. Fast talker
Yesterday I met a man at the street, he was showing the focuses. 
8. Facts speak for themselves.
10. Jump the gun.
Don't jump the gun here. Не торопись с выводами.
11. Beat a dead hourse.
Don't beat a dead hourse, time is gone.
12. Make blood boil
14. Red tape - бюрократия
15. Make or break - все или ничего
This competition will make or break me.
18. Dead right - абсолютно прав
19. Bad hairday
20. To be economical with the truth
21. Walk on eggshells


11.02.22
VOCABULARE
itchy - колючий
weeds - сорняк
curse - проклятие / материться
superstition - суеверие
sudden - внезапно
injured - раненый
theme park - парк развлечений
worth - ценность, значимость
